..........
.***......
..........
....*.....
....*.....
....*.....
.**.......
.*....**..
.*....**..
.........*
