..*.......
..*.......
..**......
..........
...***....
...*......
.**.......
**....**..
.*....***.
..........
