..........
.......*..
.....*.**.
.....*.*..
.....*....
...*......
.*.*......
..........
..........
..........
